15 15
^^^^^^^^^^^^^^^
^.^...........^
^.^.^^^^^^^^^.^
^.^.^.......^.^
^.^.^.^^^^^.^.^
^.^.^.^...^.^.^
^.^.^.^.^.^.^.^
^.^.^.^D^.^.^.^
^.^.^.^^^.^.^.^
^.^.^.....^.^.^
^.^.^^^^^^^.^.^
^.^.........^.^
^.^^^^^^^^^^^.^
^.............^
^^^^^^^^^^^^^^^