10 10
^^^^^^^^^^
^.......^^
^...^....^
^....^...^
^.*......^
^........^
^..*D..*.^
^........^
^.D....*.^
^^^^^^^^^^